NO ./textures/tex_no.xpm
SO ./textures/tex_so.xpm
WE ./textures/tex_we.xpm
EA ./textures/tex_ea.xpm


F 220,100,0
C 0,200,255

111111111111111
100000000000011
100000000000011
100000000011111
100000000011111
100110000000011
100110000N00011
100110000000011
100000000000011
111111111111111
